type: mettagrid.map_builder.ascii.AsciiMapBuilder.Config
map_data: |-
  ############################################################
  ############################################################
  ############################################################
  ############################################################
  ############################################################
  #######...######..####........#...###############..#.#######
  #######...####.....###.....+......##############......######
  ######.#...........#######.........#..##########.S....######
  #####..##..#......#########......+.#..########.......#######
  #####..#####.........#######.......##...######......########
  #####..###.........G.###.###...###.##...##.#.##..###########
  ######..##.....#.....###..#...####...##......###.###########
  ######.......#..........#....#######.##...#.#..#..##########
  ######..........###......#...#####....#..##..#.....#...#####
  #######.........##................#...###.#..#.....#.O.#####
  ##########...######....C....#.#.#............#.#.#.#...#####
  ##########.#.#####..#.......#....#........#..#.#..###.######
  ###################.#.......###...#...................######
  ###############..#.............#.....##......S.........#####
  #############.##...#########...###########.........C...#####
  #########...#.#.##.#...................###...##..#.....#####
  #######.....#...##.#.C...............O.###..####.#.....#####
  ######....##.....#.#...................###..####......######
  #######...##.......#...................###..###......#######
  #######...#.#.##...#...................#..#.###.....########
  #########....##....#...................#......#......#######
  ######.###.....#...#.........+.........#..#.#.......########
  #####...#....#.....#..@......@.....@...#.#..#.......########
  #####.....#.............................##..##.....#########
  #####..........#...........@.&.@..............##.###########
  ######..##.G..###............m...........C....##.###########
  ######.###.....##..#.....@...@.........#..........#...######
  #####..##....G.....#........a.r........#........##.....#####
  #####..#...........#.........t.........#........##.....#####
  #####...#.....#....#...................#......#..#.O..######
  #####....####.##...#...................#..............######
  #####....##........#...................#..............######
  ######...###...##..#.G...............S.#.......#.....#######
  ############.G.##..#...................#...C..#......#######
  ###########....#.#.#########...#########......####..########
  ############.G.#.#####..#..#############..####..##..########
  ###########....#.###.#..##.....###.....#..#....##...########
  ############..#........................#..#.........########
  ##########....##..#....#########...##..#..#..#......########
  ##########.G.#...#####.##........+............#....#########
  ######...........###########...................#.#..########
  ######.G...##.#.....#########.##.#..#..#####.O..#....#######
  ######......####....########...###..#..................#####
  #####........##....#########.+.#....#.........##.......#####
  #####.....##.##.....########.....#..#..#..#...######...#####
  #####..........#.+.##########......###...##...##.####..#####
  ######..............#######...#.##.####...#........##..#####
  ########...S.....##..#..##...##..#.#####.#.......S.....#####
  #########....#....#..........#####..######.............#####
  #########..####..##..#....########..######...#####...#######
  ############################################################
  ############################################################
  ############################################################
  ############################################################
  ############################################################
char_to_map_name:
  "#": wall
  ".": empty
  "@": agent.agent
  "+": junction
  "&": c:hub
  "G": germanium_extractor
  "S": silicon_extractor
  "O": oxygen_extractor
  "C": carbon_extractor
  "a": c:aligner
  "r": c:scrambler
  "m": c:miner
  "t": c:scout
