type: mettagrid.map_builder.ascii.AsciiMapBuilder.Config
map_data: |-
  ##########################################################################################
  ##########################################################################################
  ##########################################################################################
  ##########################################################################################
  ##########################################################################################
  ########...########################@.#..#..............############...#..########...######
  #######........##..###.#.##########..#..#..............############.O.#..#######....######
  ######.........##.........#########..#..#..#..###...#..############.....########...#######
  ######..##...............##..######..#.....#......O.#..############.#..#########..########
  ##########..............###....####..#.....#........#.....#######.#...########...#########
  #########............#..###.G........####..#######..#...O.#######...O.####.#.#..##########
  ######..............###.#......#..#.....#..#..#.....#.....#.#.....#......#...##.##########
  ######.........#..+.###...C.##...#......#..#..#.....#..##.#..#######...#####.....#########
  ######.........#....##......##....####..#..#..#..####..###....####......#.#...#...########
  #######..###.........#..#..###..S.#..#..#.....#..#..#.........####........#....#...#######
  ########.##...###..###.#.#........#..#..#.....#..#..#..........##....#..#..........#######
  #####..##.#...###.###..#...#.....#...#..####..#..#..#...G..#....##............#....#######
  #####.......#####.##.........######..#.....#.....#.............#...#.#.##....##.....######
  ######....#######.###.....##.##.##...#.....#..G..#..............##....###....##.....######
  #####...#...########...#......#......####..##....#..###....#.....##...##...........#######
  #####..##.G.#..##....#.#.....##..##..............#.........##...#.....####.#..O...########
  #########......#..###..##....######..............#......#.......#..######..##....#########
  ########..###..#..##..##.##...######.####.+.#.##########..S.#....##########.#..###########
  ########...#....#.#.......#.##...###.#..#...#...........#........########......###########
  ########.###.....##......#..#.....#.....#..##.##.#....+.#...##.#.####..####..##....#######
  #######..........##....#####....###.##.##.###.#.....#...#...#.#...#...#####........#######
  ######....G.......#..#######....###.##.#.#####..O.S...##..#......##...#.####.......#######
  ######...............###..##....#.........##............##...#.###......####........######
  ######......###......##........#..O...G...#####.#.##......#...##......G...###.......######
  ######.##.#.#...............#...#...#....#######..#.......#.#..#..............#....#######
  ######.###...##.......##.##....##.###...##.##...#...#....####.#...........#.#......#######
  #####..###...##..#...#......#..##.##.....#.####..#....###.#.###.#...#.....###.##.....#####
  #####..####..##.#..#.#.##...#....#.......#..####..#.+.#......###..+.#.....######.....#####
  ############.....##..###..##...#..#...#...#.....#.....#..#....#.#...#.#.....###...########
  #########.##..#####...###..#......#########...#########..##.#.#.....#.....S.##...#########
  #########.......###...#.#.#..#....#...................#......###..#..#......##.#..########
  #############..#...#..#.........###.C...............O.#....####..............####.########
  ###########.#...##......#..#.#..###...................#..#..##...............####...######
  ###########...G.#.....###...#.#####...................#.#.......#...#.#..#...####.+.######
  ##########......##.....##.#.....#.......@.........@...#.#................#.....##...######
  ##########....####....###....#.##.#...................#...#.##..S.......##..##.###.#######
  #########.....##....#..##......####.........+.........####..##....#.....##...#############
  #########.#####..........#.......##.........@.........###.#.....#.#.C......##...##########
  #######......##.##....#......#..........................#......#..............#####.######
  #######......#.####.G.##..##.#............@.&.@.........###..#...........##.O.###....#####
  #######.........###....#.##.................m...........#.###..##.............###....#####
  #######.S...#.....##.....#####.#..#.........@.........#.#.###.#.#...#.C...G.#####...######
  ######....##......#.........####.##........a.r........#.............#...#...####.....#####
  #####...#.#.....#.##.####.###.....#.........t.........##........+..##...#####........#####
  #####..##....######.###...###.....#...................#....#........#..#.##..#.......#####
  #########.C.###...#.###..##.......#...................#....####.+.G............##...######
  #########...###.....###.........#.#...................#.#######..............#.##...######
  #######..#...#....#.......S.##.##.#.G...............S.#..##.......##....#.+....#....######
  #######...##...#....#...#...#..##.#...................#.#####.#####.#..............#######
  #######....####...##..S....##.#...#########...###################.#..#..C....#......######
  #####.......##......#....###..##....######......#.....##..#######.....#..............#####
  #####...##..###...####################.##.....##.##.###....####.....###...##...#.....#####
  #####...##....##.######................##...#..#.....###.#######.....#........#.....######
  ######.#.........######................#.....##...+....#.######...##......#.........######
  #######....#..#...#####...............###............#......#.....##.###.##..........#####
  ########....#.....#####...............##..#.O........##...##.#....#######............#####
  ########......##..####................#...............######.......###.##...#.#.....######
  #######.........#.####..................O.##..+.......####.......#####.....###.....#######
  ########.....#..######.###############.....##...#..##.#####...#######..........##...######
  #########...##....###..........#######......#....#..#####......#...#...........##.O.######
  #########..#.#.#.####..........########.#####......#..##...#.#...####.......##.##...######
  #####..#..##..###.###..........#######....##.....#....##.####....#####......#####.########
  #####.........#...###..........#######.#....#.##.....#..#......####.#...#...##....########
  #####.S....#..#.G.###.......O..#########.#.##.#........##.#.C...###.....####.........#####
  #####.....#.......###..........########.......##.....###.......#.#......#....#.###...#####
  #####.....#......######.C..###########....##..##...###........##.#.#......G......##.######
  #####.......#....####......##.......##....##..##.#.#..#.....#.##...#..........##.#########
  ######.....#......###......##.......##.#####...###..........#.###.###...###...#...########
  ######............###......##.......########....#####.....#...#######....##....#....######
  #####...##........###......##.......########.#.###.............#####.#...##.#.##.....#####
  #####...##..#....###................##########..######....#......##......##.#.##.....#####
  #####.C.##.#.....##..#....#.#.#...######.#####..#####......#..........#######.#......#####
  #####...#..#.#..##..###.....#......#####.#####...#####..#.###..#......########......######
  ######.##.#.#.....####.#..#######..##.#...#..####.##.................#########.#....######
  ######.###...#...####.......####........####.####.###...##....#.....###...#####.....######
  ######..##........##.#.....##............###.####.#....####.........####...#####....######
  #######...................#.............###...##.......#####........###...#######..#######
  #######..................##.....+....#...##........##.....##.........##...################
  #######..##...##..........#........####....##......##.....................################
  #######..###..##........#..#####..#####...###...#..#####..#....#..#......#################
  ##########################################################################################
  ##########################################################################################
  ##########################################################################################
  ##########################################################################################
  ##########################################################################################
char_to_map_name:
  "#": wall
  ".": empty
  "@": agent.agent
  "+": junction
  "&": c:hub
  "G": germanium_extractor
  "S": silicon_extractor
  "O": oxygen_extractor
  "C": carbon_extractor
  "a": c:aligner
  "r": c:scrambler
  "m": c:miner
  "t": c:scout
