type: mettagrid.map_builder.ascii.AsciiMapBuilder.Config
map_data: |-
    ##################################################
    #....................#OOOO#......................#
    #....................#....#......................#
    #....................#....#......................#
    #....................#....#......................#
    #....................#....#......................#
    #....................#....#......................#
    #....................#....#......................#
    #....................#....#......................#
    #....................#....#......................#
    #....................#....#......................#
    #....................#....#......................#
    #....................#....#......................#
    #....................#....#......................#
    #....................#....#......................#
    #....................#....#......................#
    #....................#....#......................#
    #....................#....#......................#
    #....................+....+......................#
    #...##.............##+....+......................#
    ####################+#....#+######################
    #G......................@.......................C#
    #G..................@..&..@.....................C#
    #G.....................@........................C#
    #G..............................................C#
    ####################+#....#+######################
    #....................+....+......................#
    #....................#....#......................#
    #....................#....#......................#
    #....................#....#......................#
    #....................#....#......................#
    #....................#....#......................#
    #....................#....#......................#
    #....................#....#......................#
    #....................#....#......................#
    #....................#....#......................#
    #....................#....#......................#
    #....................#....#......................#
    #....................#....#......................#
    #....................#....#......................#
    #....................#....#......................#
    #....................#....#......................#
    #....................#....#......................#
    #....................#....#......................#
    #....................#....#......................#
    #....................#....#......................#
    #....................#....#......................#
    #....................#SSSS#......................#
    ##################################################
char_to_map_name:
  "#": wall
  ".": empty
  "+": junction
  "G": germanium_extractor
  "C": carbon_extractor
  "S": silicon_extractor
  "O": oxygen_extractor
  "&": c:hub
  "@": agent.agent
  "1": agent.agent
  "2": agent.agent
  "3": agent.agent
  "4": agent.agent
