type: mettagrid.map_builder.ascii.AsciiMapBuilder.Config
map_data: |-
  ######################################################################
  #C....G...O..C....+..C...................G....+..S...O..O............#
  #.+...#.......S.........#..O...S.............O.......................#
  #..#.......O........#.........+....S.O.O.......G....S.....O..........#
  #.....S................S....................G...........C......G.....#
  #...+............................................O...................#
  #.C....+.....#...........+..C...+............+......S....O...........#
  #....O.....................+..O...............C...#.....G............#
  #....#.......................................+...S............C..S...#
  #C...C....G...#.......S.......S.O..O....G.............C..............#
  #.......C..................+....................C.......+....#.......#
  #O........#.........S.C..+...#....O......#..#+.#.#.##.#.#..#.........#
  #.C.......#.+...#.S............+.G.....+.........+##...#.O.#.......O.#
  ###..S....#..#.........+........+...O......+.......#+.+.##.#.....G...#
  #..#......#...C.......C..G..................C....#+#+..##+.##........#
  #....O......C...#.....C......G....#.#......#.....#+++.#++..#.#.......#
  #.........#.........+.....#.............+.......#.###.###..#.##......#
  #.........#....#......#......#.S.......G......#...+#+#####S#........##
  #........##.+...#O.........#......C.....G.........#####+...#........O#
  #.........#.....#...........S...C..#.S........S..####+#.+..#....G....#
  #.....G....G......#.....O..........G..#.+#.C....#.+#.#.+#.#.......#..#
  #..................#...+.............+.##........S.+.......##G.......#
  #............S...........+.............#.....O.............#.........#
  #......C..#......#.....+.#.......................+.........#.......#.#
  #.........#.G#.......##+#+###+......+.....S........................#.#
  #.........#.........S.+.........+.............C.#...........O........#
  #..S...#..#+....G....S...+.#.G...#....G......+..+.+...S.......S#.....#
  ##+...O...#................................G..#O..O#..G...S#G.......G#
  #.......G.##.C#....#.......##..............#+#++##+.#+...#.C.G..S....#
  #.........#.O........C.....+..G..........G.....#...#.......#.........#
  #.......................G.....O..........S+......G........S#.........#
  #...S..O..S..............C....O.G.C....G.......G....S......#+........#
  #.........#.G.+.............................#.........#...S..........#
  #........G#...##..G.G.....+........@...........+....S...C..#....S....#
  #...#...#.##+####+................@&@....G...#.S.........+#S.........#
  #........S#.G.+.......+.#..........@.....S.................#.........#
  #.#.....#.#...#.C........................S....C..S#.S#..+..#......+.S#
  #......G..C........+..............O...O.S+..G.........#...S#....C..G.#
  #.......O..+......+.S..G...S.................S..O......+.C.#...O.+...#
  #.........#.C..........#......O..........S.........G.##.#.S#........O#
  #.........#O.#........C...O....CC......CCC.............G#..#.......S.#
  #.C.#.....##..........+.#......................G.+.........#......+..#
  #G.......O##C..+....C........G................#.C.+..O.....#.........#
  #.........##..G..+...............S.......#S.............+..#.#.....#.#
  #G.......O..........+...#......C..O.....#..#C......C.......#O.....C..#
  #.#.....+.##.........+...........+..............S......#...#..#......#
  #........O##..#.#............O......C....................C.#..G....S.#
  #.........##+.#+.S..............G.#.#.O...G#...............#.........#
  #...O.....#.+..#...+C............#.O.+..........+...S.#....#........##
  #.C.....#.#+....O........+..S#.C....#..#.#.S.#.C...G.......#.........#
  #.........##..............C.+.C.#...+..+....#...C#.....##+##....G...+#
  #.........#+........S..G.....O....+#++#....#.#.............#G.....O..#
  #..S..##..##...............#........##O.........#O...S.....#.+.......#
  #.....#..........O.G.C.....#..O.....+.........+............#.........#
  #......C............#..#.........O..#....#......G........#.#.........#
  #.........G....S....#........+......................C......#......+..#
  #S........#G.......C..........G....#.+.......G.#...S...+...#.....+...#
  #........O#...........+......+...........+................##G......S.#
  #.....G.+.#+.#..C...#..G.+.......+..................+......#........##
  #.............G............................#....C.O..O...............#
  #....#.S...............+...................#..............S..........#
  #..........C...S....#..........#.....#..#.O.......#......G..........C#
  #G...........................S...............#..S...O................#
  #......G........O..C.............S...............O..............O....#
  #.+.................G.............#......+............S#..O....+....+#
  #....................G....O............O..G.........O................#
  #....#...+............#.....................C..+.....C.C...#...#.....#
  #........................S....S.........S..#..................C......#
  #...#.......#.........G.G...C......................................O.#
  ######################################################################
char_to_map_name:
  "#": wall
  ".": empty
  "@": agent.agent
  "+": junction
  "&": c:hub
  "G": germanium_extractor
  "S": silicon_extractor
  "O": oxygen_extractor
  "C": carbon_extractor
