type: mettagrid.map_builder.ascii.AsciiMapBuilder.Config
map_data: |-
  #####################
  #####################
  #####################
  #####################
  #####################
  #####...........#####
  #####...........#####
  #####..c..+..o..#####
  #####.....@.....#####
  #####...........#####
  #####...@.&.@...#####
  #####...........#####
  #####.....@.....#####
  #####..g.....s..#####
  #####...........#####
  #####...........#####
  #####################
  #####################
  #####################
  #####################
  #####################
char_to_map_name:
  "#": wall
  ".": empty
  "c": carbon_extractor
  "+": junction
  "o": oxygen_extractor
  "@": agent.agent
  "&": c:hub
  "g": germanium_extractor
  "s": silicon_extractor
