type: mettagrid.map_builder.ascii.AsciiMapBuilder.Config
map_data: |-
  #####################
  #####################
  #####################
  #####################
  #####################
  #####.....@.....#####
  #####.###...###.#####
  #####.#.......#.#####
  #####.#.C.+.O.#.#####
  #####...........#####
  #####@....&....@#####
  #####...........#####
  #####.#.G...S.#.#####
  #####.#.......#.#####
  #####.###...###.#####
  #####.....@.....#####
  #####################
  #####################
  #####################
  #####################
  #####################
char_to_map_name:
  "#": wall
  ".": empty
  "@": agent.agent
  "+": junction
  "&": c:hub
  "C": carbon_extractor
  "O": oxygen_extractor
  "G": germanium_extractor
  "S": silicon_extractor
